2016105369
2015104409
2016104187
2015105620
2015105621
2014105611
2015100120
2016100133
2016100136
2016105963
2015104422
2015105897
2016105427
2016100168
2016104600
2016104601
2014105623
2014104609
2011101423
2012104141
2013104138
2008102704
2012102000
2013104574
2012100136
2011104087
2015104269
2014103634
2013103417
2015103496
2015103742
2009100151
2010100167
2013104591
2013100173
2011104103
2015101737
2007102680
2010104357
2015104535
2016103414
2008100424
2016103415
2015103752
2011103660
2008103385
2010103442
2011100412
2008101021
2010100215
2012100251
2013103614
2012100281
2010100240
2013104385
2013104207
2015100330
2010104276
2011104161
2009103755
2011101546
2016103614
2009104260
2010104655
2010104184
2013103764
2009100329
2016102051
2009100336
2013100467
2014105516
2010103534
2013103454
2011101759
2010100355
