2015105899
2017105517
2014102148
2015105845
2015100123
2014105612
2017105142
2016100156
2017105765
2015100154
2011101423
2014104171
2014101705
2014104172
2016100197
2013104567
2010100113
2014101390
2012103690
2017104050
2012104150
2011105018
2014104308
2016104213
2011100120
2017103291
2012104162
2016104765
2012100435
2011104095
2013100150
2014100199
2013101732
2014102146
2014103103
2017104233
2012103636
2016102204
2013102056
2013104599
2013101736
2011100177
2014101404
2014104213
2016104243
2010105692
2011104231
2016103709
2008102616
2010104631
2015101688
2016104800
2014104235
2012103528
2011102993
2011105229
2017105266
2011101535
2012100326
2012101507
2014103677
2012103795
2017101575
2017100374
2017104119
2012103481
2012103355
2014100361
2012100498
2013104347
2012104240
2012104247
2015104349
2011104186
2013104245