2014280442
2016280245
2014280055
2011120266
2012120125
2012120126
2013120158
2013120249
2014100100
2015100011
2015100016
2015100045
2016100008
2016100023
2016100067
2016120070
2014170839
2015131204
2011130839
2014130623
2014130657
2015130918
2013130637
2013130649
2015131035
2015131038
2016131008
2014130217
2014130224
2014130229
2014130246
2015130319
2015130325
2016130307
2012130229
2013130016
2013130161
2013130254
2014130335
2014130337
2014130346
2014130356
2014130375
2014130379
2015130506
2015130511
2015130534
2016130538
2013130109
2015100085
2013130708
2015130734
2016130730
2016130735
2016130784
2012130797
2014130721
2014130737
2014130762
2015131154
2014130140
2015130141
2014130174
2014130175
2015130205
2015130211
2015130212
2015130216
2015130223
2016130209
2016130221
2016130225
2013100041
2013240092
2013240093
2014240024
2015250410
2015250299
2012190510
2014190503
2014190020
2015190054
2014190222
2016190260
2013140333
2011140513
2013140548
2014140634
2015140607
2014140515
2013160122
2014160025
2014160031
2014260023
2015260131
2012300082
2013150213
2014100017
2014100067
2014150422
2015150136
2015150163
2015150191
2015150210
2015150211
2015150282
2015150297
2015280071
2016100003
2016100012
2016100016
2016100019
2016100040
2016100062
2011100009
2012100041
2014100008
2014100039
2014150120
2015150093
2015150108
2015150220
2015150232
2016100044
2016100066
2016150010
2016150041
2016150062
2016150065
2016150089
2016150116
2017150041
2014150022
2014150346
2015100050
2015150006
2011150308
2012100077
2014100013
2014150146
2014150225
2014150230
2014150302
2014150317
2014150377
2015150309
2015150315
2015150322
2015150324
2015150326
2015150342
2016150515
2016150526
2016150571
2016150610
2015410006