2016105804
2015104570
2017105631
2015105973
2015105976
2015105978
2018104511
2015106005
2017100166
2016104204
2018105362
2016105455
2017104510
2017103577
2016104216
2015103182
2013104150
2014105454
2013105163
2011104942
2016105476
2017100226
2013102191
2011100148
2016103781
2016102121
2014100216
2014105465
2012104616
2018102315
2017104076
2013104172
2017104527
2016100489
2014104208
2011101582
2014110129
2014104210
2018105420
2015104295
2014100119
2016105517
2010101524
2013103722
2017101469
2012101695
2016100333
2015104479
2012104212
2014105337
2013104205
2012104216
2016104265
2016103674
2015105561
2011100291
2013100314
2017105285
2015101648
2012103665
2014103495
2013103639
2015104679
2015103883
2017105432
2013104637
2012101665
2014104272
2016103507
2013105319
2015104352
2014104277
2014105516
2015103671
2017104143
2015105480
2018104714
2011100308
2011100229
2013100355
2013100314
