2017120078
2014230081
2015130051
2017130022
2014130623
2016130907
2015131035
2017131037
2013130057
2014130201
2015130319
2015130341
2016130302
2016130320
2017130312
2017130350
2015130506
2017130503
2017130532
2017130546
2017130569
2017131432
2016130450
2014130965
2014130543
2015130756
2016130749
2017130719
2017130772
2017131342
2014130714
2014130721
2016131128
2017131119
2014130140
2016130105
2015130211
2016130223
2016130225
2017130226
2014250410
2015190003
2017190011
2017190104
2017190603
2017190608
2017190628
2017190401
2017190430
2014140609
2013160175
2018100009
2018100012
2018100030
2018100031
2018100032
2018100036
2018100040
2018100045
2018100047
2018100049
2018100051
2018100053
2018100058
2018100061
2018100065
2018100081
2018100086
2018100089
2018100090
2018100094
2018100096
2018100105
2018100110
2018100112
2012260319
2014100067
2014150298
2015150146
2016150251
2016150744
2017100092
2018150231
2018150247
2018150288
2018150346
2015150364
2014150122
2014150241
2015100064
2015150120
2016150066
2017150013
2017150021
2017150026
2017150057
2017150060
2017150100
2014150025
2015100046
2015100050
2014100013
2014150310
2017150538
2017150540
2017150557
2017150564
2017150565
2015410006
2017121009
2015123043
2017123016
2013110048
2017112075
2014112083
2014112070
2016112050
2015116035
2015116033
2015116028
2017117009
2017117010
2017118023
2017118021
2009111257
2015113012
2012113025
2017114026
2017114032
2016114031
2014115002
2017121080
2017121129
2015121006
2017121071
2014121166
2016121218
2014121128
2017122017
2014122018
2017131010
2011131025
2014143539
2012147045
2017147565
2016162012
2015124096
2017124035
2017124068
2017124066
2015125059
2017125090
2015125047
2016125072
2017125020
2015125023
2015125071
2017125074
2017125068
2016125058
2013125033
2016125002
2016125059
2016125078
2017126025
2017126021
2017126020
2017126003
2017127001
2016127044
2016129014
2014129042
2016151012
2016151014
2018311685
2017182054
2017182055
2015123133
2015123233
2015123069
2015123264
2015123315
2017123205
2015123140
2017123268
2017123228
2017123250
2015101010
2015123181
2015123258
2016123166
2014123245
2014123227
2014123256
2014123203
2015123042
2014123222
2014123006
2013123033
2007122253
2011123053
2012123184
2015123288
2014123108
2017190186
2014190163
2014190071
2017190095
2015197005
2017195023