D101083044
D101082784
D101083045
R101089600
R101108023
R101108284
R101109106
R101106888
H101034360
S101137743
S101123837
S101117443
S101131821
s101138876
S101117444
S101120243
S101139150
S101123827
S101120113
S101117441
S101130696
S101137731
S101137734
S101140755
S101102275
S101117440
S101117439
S101110107
S101139270
C101090827
C101090826
C101094782
C101086192
C101046524
C101104898
C101106294
C101106289